









    A  TT
   XXXXX            CXX
   XXXXXX       TBXXXXXXXX
X          XXXXXXXXX
         XXXXXXXXXX




XXXXXXXXXXXXXXXXXXXXXXXXXXX